border_size=1
usage=map

_s, _s, _s, _s, _s, _s, _s, _s, _s, _s, _s, _s, _s, _s, _s, _s, _s, _s, _s, _s, _s, _s, _s, _s, _s, _s, _s, _s, _s
_s, _s, _s, _s, _s, _s, _s, _s, _s, _s, _s, _s, _s, _s, _s, _s, _s, _s, _s, _s, _s, _s, _s, _s, _s, _s, _s, _s, _s
_s, _s, _s, _s, _s, _s, _s, _s, _s, _s, Gg, Ww, Gs^Fp, Gg, Gg^Es, Gg^Es, Hh, Rp, Gg, _s, _s, _s, _s, _s, _s, _s, _s, _s, _s
_s, _s, _s, _s, _s, _s, _s, _s, Gg, Gg, Gg, Ww, Ww, Gs, Gg, Gs^Fp, Rp, Rp, Gg, Gg, Gg, _s, _s, _s, _s, _s, _s, _s, _s
_s, _s, _s, _s, _s, _s, Gg, Gg^Es, Gs, Gg, Hh, Gg^Es, Wwf, Gg, Gs, Mm, Rp, Gg, Gs^Fp, Gg^Em, Ww, Ww, Gg, _s, _s, _s, _s, _s, _s
_s, _s, _s, _s, _s, Gg^Es, Gd^Gvs, Re^Gvs, Gg, Gs^Fp, Mm^Vhh, Ww, Gs^Fp, Gg, Rp, Rp, Gg, Gg, Gg^Vc, Hh, Ww, Hh, Gg, Gg, _s, _s, _s, _s, _s
_s, _s, _s, _s, Gg^Es, Gg, Re^Gvs, Gd^Gvs, Gg, Ds, Ww, Ww, Gg, Gg, Chr, Gg, Gs^Fms, Gs, Gg, Gg^Es, Gg, Ww, Gg^Wm, Gg, Gg^Es, _s, _s, _s, _s
_s, _s, _s, _s, Gg, Gg, Gg, Gg, Gg^Es, Ww, Ss, Ds, Hh, Gg, Ww^Bsb|, Gg, Hh^Vhh, Mm, Gg, Gg, Ww, Ww, Gg, Gg, Gg, _s, _s, _s, _s
_s, _s, _s, Gg, Gg^Em, Gg^Wm, Ww, Ds, Ww, Ww, Ww, Ss^Vhs, Wwf, Ww, 1 Kh, Ww, Wwf, Hh^Fms, Gg, Hh, Ww, Ds, Gg, Re^Gvs, Gd^Gvs, Gg^Es, _s, _s, _s
_s, _s, _s, Gg, Hh, Ww, Gg, Ww, Hh, Mm, Ww, Ww, Ch, Ch, Gg, Ch, Ch, Ww, Ww, Mm, Ww, Gg^Es, Gg, Gd^Gvs, Re^Gvs, Gg, _s, _s, _s
_s, _s, _s, Ww, Ww, Ww, Gg, Gg^Es, Gg, Gg, Ww, Chw, Gs^Vh, Gg, Gg, Gg, Gs^Vh, Chw, Ww, Ww, Ss, Ww, Ds, Gg, Gs, Gg^Es, _s, _s, _s
_s, _s, _s, Gg, Gs, Hh, Gg^Vc, Gg, Mm, Hh^Fms, Wwf, Ch, Gg, Rp, Rp^Vov, Rp, Gg, Ch, Wwf, Ss^Vhs, Ds, Ww, Mm^Vhh, Gs^Fp, Gg, Gg, _s, _s, _s
_s, _s, _s, Gg, Gg^Es, Gs^Fp, Gg, Gs^Em, Gs^Fms, Hh^Vhh, Ww, Ch, Gg, Gg, Rp, Gg, Gg, Ch, Ww, Hh, Gg, Ww, Ww, Hh, Gg, Gg, _s, _s, _s
_s, _s, _s, Gg, Rp, Gg, Rp, Gg, Gg, Gg, Ww^Bsb/, 2 Kh, Ch, Gg, Gs^Vh, Gg, Ch, 3 Kh, Ww^Bsb\, Gg, Gg, Gs^Fp, Wwf, Gg, Ww, Gg, _s, _s, _s
_s, _s, _s, Rp, Hh, Rp, Mm, Rp, Rp, Chr, Gg, Ww, Wwf, Ch, Chw, Ch, Wwf, Ww, Gg, Chr, Rp, Gg, Gg, Ww, Gs^Fp, Ww, _s, _s, _s
_s, _s, _s, Gg, Gg, Gs^Fp, Gg, Gs, Gg, Gg, Gg, Hh, Ss^Vhs, Ww, Ww, Ww, Hh^Fms, Hh^Vhh, Gs^Fms, Gg, Rp, Gs, Gg, Gs, Gg, Gg, _s, _s, _s
_s, _s, _s, _s, Gg, Gg^Es, Gs, Gg, Wwf, Gs^Fp, Ww, Ds, Ss, Ww, Mm, Gg, Gg, Mm, Gs, Gg^Es, Rp, Mm, Gs^Fp, Gg^Es, Gg, _s, _s, _s, _s
_s, _s, _s, _s, _s, Gg, Gs^Fp, Ww, Gg, Ww, Mm^Vhh, Ww, Ww, Ww, Ww, Hh, Gg, Gg^Es, Gg^Vc, Gg, Gg, Rp, Hh, Gg, _s, _s, _s, _s, _s
_s, _s, _s, _s, _s, Gg, Ww, Ww, Gg, Hh, Gs^Fp, Ds, Gg, Gg^Es, Ds, Ww, Gg, Gg, Hh, Gs^Fp, Gg, Rp, Rp, Gg, _s, _s, _s, _s, _s
_s, _s, _s, _s, _s, _s, _s, Gg, Gg^Es, Gg, Gs, Gg^Es, Gd^Gvs, Gg, Gg, Ww, Ww, Ww, Ww, Gs, Gg, Gg, _s, _s, _s, _s, _s, _s, _s
_s, _s, _s, _s, _s, _s, _s, _s, _s, Gg, Gg^Es, Re^Gvs, Gd^Gvs, Re^Gvs, Gg, Gg^Wm, Gg, Hh, Ww, Gg, _s, _s, _s, _s, _s, _s, _s, _s, _s
_s, _s, _s, _s, _s, _s, _s, _s, _s, _s, _s, Gg, _s, Gg^Es, _s, Gg^Es, _s, Gg, _s, _s, _s, _s, _s, _s, _s, _s, _s, _s, _s
_s, _s, _s, _s, _s, _s, _s, _s, _s, _s, _s, _s, _s, _s, _s, _s, _s, _s, _s, _s, _s, _s, _s, _s, _s, _s, _s, _s, _s
_s, _s, _s, _s, _s, _s, _s, _s, _s, _s, _s, _s, _s, _s, _s, _s, _s, _s, _s, _s, _s, _s, _s, _s, _s, _s, _s, _s, _s
